11111111111111111111111111111111111111111111111111111111111111111
11111111111111111111111111111111111111111111111111111111111111111
10000000000000000001aaaaaaaaaaaaaaa111111111111111111111111111111
1000000001000000111100000000000000a111111111111111111111111111111
1000000000000000000000000000000000a111111111111111111111111111111
1000010000000000111100000000000000a111111111111111111111111111111
10000000000000000001aaaaaaaaaaaaaaa111111111111111111111111111111
10000000010000000001111111111111111111111111111111111111111111111
10000000000000000011111111111111111111111111111111111111111111111
10000100000000000001111111111111111111111111111111111111111111111
10000000000000001111000000000000001111111111111111111111111111111
10000000010000000000000000000000001111111111111111111111111111111
10000000000000001111000000000000001111111111111111111111111111111
10000100000000000001111111111111111111111111111111111111111111111
10000000000000000001111111111111111111111111111111111111111111111
10000000010000000001111111111111111111111111111111111111111111111
10000000000000001111000000000000001111111111111111111111111111111
10000100000000000000000000000000001111111111111111111111111111111
10000000000000001111000000000000001111111111111111111111111111111
10000000010000000001111111111111111111111111111111111111111111111
10000000000000000011111111111111111111111111111111111111111111111
10000100000000000001111111111111111111111111111111111111111111111
10000000000000001111000000000000001111111111111111111111111111111
10000000010000000000000000000000001111111111111111111111111111111
10000000000000001111000000000000001111111111111111111111111111111
11111111111111111111111111111111111111111111111111111111111111111
11111111111111111111111111111111111111111111111111111111111111111
