11111111111111111111111111111111111111111111111111
11111111111111111111111111111111111111111111111111
11111111111111111111111111111111111111111111111111
111111111111111111111111111111111111111111aaaaaaaa
1000001111111111100000001110000000011111111000000a
1000001111111111101111101110101010011110000000000a
1000000000000111101111101110000000011110111000000a
100000111111011110111110000001001000000011a000000a
100000111111011110111111111000000001111111aaaaaaaa
10000011111100000011111111100010100111111111111111
11111111111111111111111111111111111111111111111111
11111111111111111111111111111111111111111111111111
11111111111111111111111111111111111111111111111111
11111111111111111111111111111111111111111111111111