111111111111111111111111111111111111111111111111111111111111111111
111111111111111111111111111111111111111111111111111111111111111111
111111111111111111111111111111111111111111111111111111111111111111
1111111111111111111111111111111111111111111111111111111111aaaaaaaa
10000011111111111000000000000000000000001110000000011111111000000a
10000011111111111011111111111111111111101110101010011110000000000a
10000000000001111011111111111111111111101110000000011110111000000a
1000001111110111101111111111111111111110000001001000000011a000000a
1000001111110111101111111111111111111111111000000001111111aaaaaaaa
100000111111000000111111111111111111111111100010100111111111111111
111111111111111111111111111111111111111111111111111111111111111111
111111111111111111111111111111111111111111111111111111111111111111
111111111111111111111111111111111111111111111111111111111111111111
111111111111111111111111111111111111111111111111111111111111111111