11111111111
111111111111111111111111111111111111111111111111111
1200000000000000000000000000000000000000000000000011
100000011111111111111111111111111111111111111111111
1201111000001
1111111111
