11111111111
11111111111111111111111111111111111111111111111111111
1200000000000000000000000000000000000000000000000011
1000000111111111111111111111111111111111111111111111
1201111000001
1111111111
